182;182;182;182;182;182;182;182;182;182
240;240;240;240;240;240;240;240;240;240
240;240;240;240;240;240;240;240;240;240
240;240;240;240;240;240;240;240;240;240
240;240;240;240;240;240;240;240;240;240
240;240;240;240;240;240;240;240;240;240
240;240;240;240;240;240;240;240;240;240
240;240;240;240;240;240;240;240;240;240
36;36;36;36;36;36;36;36;36;36
52;52;52;52;52;52;52;52;52;52