182;182;182;182;182;182;182;182;182;240
167;240;240;240;240;240;240;240;240;167
167;240;240;240;240;146;147;148;240;167
167;240;240;240;240;162;163;164;240;167
167;240;240;240;240;178;179;180;240;167
167;240;146;147;148;240;240;240;240;167
167;240;162;163;164;240;240;240;240;167
167;240;178;179;180;240;240;240;240;167
181;151;240;240;240;240;240;240;240;167
213;182;182;182;182;182;182;182;182;213